.......#.......#.....................#.................................
.#####.###.#####.##.######.#######.#.#####..#####..#...................
.#.........#.......#.....#.......#.#.#...#.#...#...#...................
.###########.#######..#..#######.#.#.#.#.##..#.#..##.....#.............
.#...........#.#.....#.#.....#.#.#.#...#...#.#...#.......#.............
.#.##########..#.###....###..#.#.#.#######.#.#####.##..................
.#.#...#.......#.#.....#.....#.#.#.#.........#.........................
.#.#.#...###.#.#.###.#....####.#.#.#.#########...#.............#.......
.#.#.#.....#.#.#...#.#.#.....#...#.#...#...#.........#.................
.#.##.####.#.#..##.#.#..####.#####.#...#...#.###...#...#...............
...#.....#...#.#.#.........#.....#.#.....#.#.#.........................
.###.###.#.###.#.#.......#.#####.#.#####.###.#.........................
...#...#.#.#.....#...#.....#...#.#...#.....#...........................
##.###.#.#.#######.##....#..##.#.#.#.#.###.##..........#...............
.#...#.#...#.....#...#.........#.#.#.#.#.....#.........................
.###.#.#####.....#.#.##...#..#...#.#.#.#.###.#.........................
...#...#...#...#...#...........#.#.#.#.#...#.#.........................
.#####.#....##.#.....#....#....#.#.#.#.#.#.#.##........................
.#...#.#.#.....#.................#.#...#.#.......#.....................
.#.#.#.#.#...#....##.#.........#.#.####..#..#####.#..##................
.#.#...#.#...#.....#.............#...#...........#.....................
.#.##.##.#.............#........#.##.#.##....#...#.....................
.....#...#.#...................#...#.#.................................
.#####..#..#.#.#....#.......##.#..##.#.##..#....#......................
...#...#.....................#.#.#...#.#...............................
.###.##......................#.#.#.###...#.............................
.#...#...#.....................#.....#.................................
##..#...........................####.#.#.............................##
...#...#.........................#...#.#.#.#...........................
.##.##........................#..#.#####.#.#.....................#####.
.#...#.#.......................#.#.......#.......................#.#...
.#.#..............................########.#.....................#.#.#.
...#...............................#.......#.......................#.#.
##.#...#.........................#...#.................#......#....#.#.
.....................................#.............................#.#.
....#........#.....................#....................#..#.....###.#.
.................................................................#...#.
..#.#...#........................................................#.###.
.......#.......................................................#.#...#.
.......................................................#...##..#.###.##
.......................................................#.......#...#...
..#................................................#.....#.#.#.#######.
...........................................................#.#.#.......
......................................................#...#..#.#.###...
.................................................#.............#...#.#.
.#......................................................#.########.#.#.
...................................................#.......#.......#...
..............................................#..#....#.#..#.#.########
.................................................#.....#...#.#.#.......
...........................................###.#...#.....#.#.###.#####.
.................................................#.........#.........#.
.........................................#.#########.######...##..####.
...............................................#...#.#.....#.....#.....
..................................############.#.#.###.###.#####.#.####
...................................#.........#...#.#...#.#.#...#.#.....
................................##..########.#####.#.###.#.#.#.#.#####.
.................................#.....#.....#.....#.#.....#.#.#.....#.
.......................................#.###.#.#####.#####.#.#.#######.
...................................#.#.#.#...#...#.......#...#.#.....#.
...............................#...#.#.#.#.#.###.###..##..####.#.###.#.
.................................#.....#.#.....#...#.#...#...#.#...#...
...........................#..##.#######.##.##.###.#.#.####..#.#.#.##..
...........................#.....#.....#...#...#...#.#.#.....#...#.#...
...........................#######.###.#.#.###.#.###.#.#.###.#.###.##..
...........................#.......#.#.#.#...#.#.#...#.#.#...#...#...#.
................................####.#.#.###.#.#.#####.#.#######.###.##
.....................................#.#...#.#.#.......#...#...#...#...
................................##..##..##.#..############.#.#...#.###.
.................................#.#.....#.#.#.....#.......#.#...#...#.
...................................#.#####.#.#.#.###.###.###.#.##.##.#.
...................................#.......#...#.......#.....#.........
