#########################################################################
#S......#.......#.....................#.................................#
#.#####.###.#####.##.######.#######.#.#####..#####..#...................#
#.#.........#.......#.....#.......#.#.#...#.#...#...#...................#
#.###########.#######..#..#######.#.#.#.#.##..#.#..##.....#.............#
#.#...........#.#.....#.#.....#.#.#.#...#...#.#...#.......#.............#
#.#.##########..#.###....###..#.#.#.#######.#.#####.##..................#
#.#.#...#.......#.#.....#.....#.#.#.#.........#.........................#
#.#.#.#...###.#.#.###.#....####.#.#.#.#########...#.............#.......#
#.#.#.#.....#.#.#...#.#.#.....#...#.#...#...#.........#.................#
#.#.##.####.#.#..##.#.#..####.#####.#...#...#.###...#...#...............#
#...#.....#...#.#.#.........#.....#.#.....#.#.#.........................#
#.###.###.#.###.#.#.......#.#####.#.#####.###.#.........................#
#...#...#.#.#.....#...#.....#...#.#...#.....#...........................#
###.###.#.#.#######.##....#..##.#.#.#.#.###.##..........#...............#
#.#...#.#...#.....#...#.........#.#.#.#.#.....#.........................#
#.###.#.#####.....#.#.##...#..#...#.#.#.#.###.#.........................#
#...#...#...#...#...#...........#.#.#.#.#...#.#.........................#
#.#####.#....##.#.....#....#....#.#.#.#.#.#.#.##........................#
#.#...#.#.#.....#.................#.#...#.#.......#.....................#
#.#.#.#.#.#...#....##.#.........#.#.####..#..#####.#..##................#
#.#.#...#.#...#.....#.............#...#...........#.....................#
#.#.##.##.#.............#........#.##.#.##....#...#.....................#
#.....#...#.#...................#...#.#.................................#
#.#####..#..#.#.#....#.......##.#..##.#.##..#....#......................#
#...#...#.....................#.#.#...#.#...............................#
#.###.##......................#.#.#.###...#.............................#
#.#...#...#.....................#.....#.................................#
###..#...........................####.#.#.............................###
#...#...#.........................#...#.#.#.#...........................#
#.##.##........................#..#.#####.#.#.....................#####.#
#.#...#.#.......................#.#.......#.......................#.#...#
#.#.#..............................########.#.....................#.#.#.#
#...#...............................#.......#.......................#.#.#
###.#...#.........................#...#.................#......#....#.#.#
#.....................................#.............................#.#.#
#....#........#.....................#....................#..#.....###.#.#
#.................................................................#...#.#
#..#.#...#........................................................#.###.#
#.......#.......................................................#.#...#.#
#.......................................................#...##..#.###.###
#.......................................................#.......#...#...#
#..#................................................#.....#.#.#.#######.#
#...........................................................#.#.#.......#
#......................................................#...#..#.#.###...#
#.................................................#.............#...#.#.#
#.#......................................................#.########.#.#.#
#...................................................#.......#.......#...#
#..............................................#..#....#.#..#.#.#########
#.................................................#.....#...#.#.#.......#
#...........................................###.#...#.....#.#.###.#####.#
#.................................................#.........#.........#.#
#.........................................#.#########.######...##..####.#
#...............................................#...#.#.....#.....#.....#
#..................................############.#.#.###.###.#####.#.#####
#...................................#.........#...#.#...#.#.#...#.#.....#
#................................##..########.#####.#.###.#.#.#.#.#####.#
#.................................#.....#.....#.....#.#.....#.#.#.....#.#
#.......................................#.###.#.#####.#####.#.#.#######.#
#...................................#.#.#.#...#...#.......#...#.#.....#.#
#...............................#...#.#.#.#.#.###.###..##..####.#.###.#.#
#.................................#.....#.#.....#...#.#...#...#.#...#...#
#...........................#..##.#######.##.##.###.#.#.####..#.#.#.##..#
#...........................#.....#.....#...#...#...#.#.#.....#...#.#...#
#...........................#######.###.#.#.###.#.###.#.#.###.#.###.##..#
#...........................#.......#.#.#.#...#.#.#...#.#.#...#...#...#.#
#................................####.#.#.###.#.#.#####.#.#######.###.###
#.....................................#.#...#.#.#.......#...#...#...#...#
#................................##..##..##.#..############.#.#...#.###.#
#.................................#.#.....#.#.#.....#.......#.#...#...#.#
#...................................#.#####.#.#.#.###.###.###.#.##.##.#.#
#...................................#.......#...#.......#.....#........E#
#########################################################################
